NO assets/simonkraft/soul_sand.xpm
SO assets/simonkraft/respawn_anchor_side2.xpm
WE assets/simonkraft/soul_soil.xpm
EA assets/simonkraft/soul_sand.xpm

C 53,41,34
F 45,33,27

11111
10001
10N01
10001
11111