NO assets/wall.xpm
SO assets/floor.xpm
WE assets/door_opened.xpm
EA assets/cheese_maze.xpm

F 220,100,0
C 225,30,0

        1111111111111111111111111
        1000000000110000000000001
        1011000001110000000000001
        1001000000000000000000001
111111111011000001110000000000001
100000000011000001110111111111111
111101111111110111000000100111111111111111
111101111111110111010100100000000000000001
110000001101010111000000100011111111111111
10000000000000000000000000N01
10000000000000001101010010001
1100000111010101111101111000111
11110111 1110101 101111010001
11111111 1111111 111111111111
