NO assets/test/north.xpm
SO assets/test/south.xpm
WE assets/test/west.xpm
EA assets/test/east.xpm

F 20,20,20
C 200,200,200

111111111111111111111
1000000000000000000W1
111111111111111111111
