







NO assets/wall.xpm








SO assets/floor.xpm
                        WE assets/door_opened.xpm
        EA assets/cheese_maze.xpm            

        F 20,           20,             20
C 200,          200,200

11111
10P01
10S01                
10001
10001
10001
11001               
10001
10001
10001
10001
10001
11111           
