111111111
100000001
100000101
10000P001
100100001
100000001
111111111
