111111111111111111111111111111111111111111
100000000000000000011000000000000000000001
100111111000000000011000000000000000000001
100000000000000000011000000000000110000001
100000000000000000011000000000000110000001
1001000000P0000000010000000000000110000001
100100000000000000000000000000000110000001
100100000000000000000000000000000110000001
100111100000000000000000000000000110000001
100111111111111100000000000000000110000001
100000000000000000000000000000000000000001
100000000000000000000000000000000000000001
111111111111111111111111111111111111111111