1111111111111
1000000010001
1000001010001
10000P0010001
1001000000001
1000000000001
1111111111111
