1111111111111
1000000010001
1010000010001
1010000010001
1010011110001
1P00000000001
1111111111111
