111111111
100000001
100000001
10000P001
111111111
